{
  "map": [
    ["130400", "130400", "130400", "130400", "130400", "130400", "130400", "130400", "130400", "130400", "130400", "130400", "130400", "130400", "130400", "130400", "130400", "130400", "130400", "130400", "130400", "130400", "130400", "130400", "130400", "130400", "130400", "130400", "130400", "130400", "130400", "130400", "130400", "130400", "130400", "130400", "130400", "130400", "130400", "130400", "130400", "130400", "130400", "130400", "130400", "130400", "130400", "130400", "130400", "130400", "130400", "130400", "130400", "130400", "130400", "130400", "130400", "130400", "130400", "130400", "130400", "130400", "130400", "130400", "130400", "130400", "130400", "130400", "130400", "130400", "130400", "130400", "130400", "130400", "130400", "130400", "130400"],
    ["130400", "130300", "130400", "000000", "000000", "000000", "000000", "000000", "000000", "000000", "000000", "000000", "000000", "000000", "000000", "000000", "000000", "000000", "000000", "000000", "000000", "000000", "000000", "000000", "000000", "000000", "000000", "000000", "000000", "000000", "000000", "000000", "000000", "000000", "000000", "000000", "000000", "000000", "000000", "000000", "000000", "000000", "000000", "000000", "000000", "000000", "000000", "000000", "000000", "000000", "000000", "000000", "000000", "000000", "000000", "000000", "000000", "000000", "000000", "000000", "000000", "000000", "000000", "000000", "000000", "000000", "000000", "000000", "000000", "000000", "000000", "000000", "000000", "000000", "000000", "000000", "130400"],
    ["130400", "130000", "130400", "130400", "130400", "130400", "130400", "000000", "000000", "000000", "000000", "000000", "000000", "000000", "000000", "000000", "000000", "000000", "000000", "000000", "000000", "000000", "000000", "000000", "000000", "000000", "000000", "000000", "000000", "000000", "000000", "000000", "000000", "000000", "000000", "000000", "000000", "000000", "000000", "000000", "000000", "000000", "000000", "000000", "000000", "000000", "000000", "000000", "000000", "000000", "000000", "000000", "000000", "000000", "000000", "000000", "000000", "000000", "000000", "000000", "000000", "000000", "000000", "000000", "000000", "000000", "000000", "000000", "000000", "000000", "000000", "000000", "000000", "000000", "000000", "000000", "130400"],
    ["130400", "000000", "000000", "000000", "000000", "000000", "130400", "000000", "000000", "000000", "000000", "000000", "000000", "000000", "000000", "000000", "000000", "000000", "000000", "000000", "000000", "000000", "000000", "000000", "000000", "000000", "000000", "000000", "000000", "000000", "000000", "000000", "000000", "000000", "000000", "000000", "000000", "000000", "000000", "000000", "000000", "000000", "000000", "000000", "000000", "000000", "000000", "000000", "000000", "000000", "000000", "000000", "000000", "000000", "000000", "000000", "000000", "000000", "000000", "000000", "000000", "000000", "000000", "000000", "000000", "000000", "000000", "000000", "000000", "000000", "000000", "000000", "000000", "000000", "000000", "000000", "130400"],
    ["130400", "000000", "000000", "000000", "000000", "000000", "130400", "000000", "000000", "000000", "000000", "000000", "000000", "000000", "000000", "000000", "000000", "000000", "000000", "000000", "000000", "000000", "000000", "000000", "000000", "000000", "000000", "000000", "000000", "000000", "000000", "000000", "000000", "000000", "000000", "000000", "000000", "000000", "000000", "000000", "000000", "000000", "000000", "000000", "000000", "000000", "000000", "000000", "000000", "000000", "000000", "000000", "000000", "000000", "000000", "000000", "000000", "000000", "000000", "000000", "000000", "000000", "000000", "000000", "000000", "000000", "000000", "000000", "000000", "000000", "000000", "000000", "000000", "000000", "000000", "000000", "130400"],
    ["130400", "130000", "000000", "000000", "000000", "000000", "130400", "000000", "000000", "000000", "000000", "000000", "000000", "000000", "000000", "000000", "000000", "000000", "000000", "000000", "000000", "000000", "000000", "000000", "000000", "000000", "000000", "000000", "000000", "000000", "000000", "000000", "000000", "000000", "000000", "000000", "000000", "000000", "000000", "000000", "000000", "000000", "000000", "000000", "000000", "000000", "000000", "000000", "000000", "000000", "000000", "000000", "000000", "000000", "000000", "000000", "000000", "000000", "000000", "000000", "000000", "000000", "000000", "000000", "000000", "000000", "000000", "000000", "000000", "000000", "000000", "000000", "000000", "000000", "000000", "000000", "130400"],
    ["130400", "000000", "000000", "000000", "000000", "000000", "130400", "000000", "000000", "000000", "000000", "000000", "000000", "000000", "000000", "000000", "000000", "000000", "000000", "000000", "000000", "000000", "000000", "000000", "000000", "000000", "000000", "000000", "000000", "000000", "000000", "000000", "000000", "000000", "000000", "000000", "000000", "000000", "000000", "000000", "000000", "000000", "000000", "000000", "000000", "000000", "000000", "000000", "000000", "000000", "000000", "000000", "000000", "000000", "000000", "000000", "000000", "000000", "000000", "000000", "000000", "000000", "000000", "000000", "000000", "000000", "000000", "000000", "000000", "000000", "000000", "000000", "000000", "000000", "000000", "000000", "130400"],
    ["130400", "000000", "000000", "000000", "000000", "000000", "130400", "000000", "000000", "000000", "000000", "000000", "000000", "000000", "000000", "000000", "000000", "000000", "000000", "000000", "000000", "000000", "000000", "000000", "000000", "000000", "000000", "000000", "000000", "000000", "000000", "000000", "000000", "000000", "000000", "000000", "000000", "000000", "000000", "000000", "000000", "000000", "000000", "000000", "000000", "000000", "000000", "000000", "000000", "000000", "000000", "000000", "000000", "000000", "000000", "000000", "000000", "000000", "000000", "000000", "000000", "000000", "000000", "000000", "000000", "000000", "000000", "000000", "000000", "000000", "000000", "000000", "000000", "000000", "000000", "000000", "130400"],
    ["130400", "000000", "000000", "130000", "130000", "130000", "130400", "000000", "000000", "000000", "000000", "000000", "000000", "000000", "000000", "000000", "000000", "000000", "000000", "000000", "000000", "000000", "000000", "000000", "000000", "000000", "000000", "000000", "000000", "000000", "000000", "000000", "000000", "000000", "000000", "000000", "000000", "000000", "000000", "000000", "000000", "000000", "000000", "000000", "000000", "000000", "000000", "000000", "000000", "000000", "000000", "000000", "000000", "000000", "000000", "000000", "000000", "000000", "000000", "000000", "000000", "000000", "000000", "000000", "000000", "000000", "000000", "000000", "000000", "000000", "000000", "000000", "000000", "000000", "000000", "000000", "130400"],
    ["130400", "000000", "000000", "000000", "000000", "000000", "130400", "000000", "000000", "000000", "000000", "000000", "000000", "000000", "000000", "000000", "000000", "000000", "000000", "000000", "000000", "000000", "000000", "000000", "000000", "000000", "000000", "000000", "000000", "000000", "000000", "000000", "000000", "000000", "000000", "000000", "000000", "000000", "000000", "000000", "000000", "000000", "000000", "000000", "000000", "000000", "000000", "000000", "000000", "000000", "000000", "000000", "000000", "000000", "000000", "000000", "000000", "000000", "000000", "000000", "000000", "000000", "000000", "000000", "000000", "000000", "000000", "000000", "000000", "000000", "000000", "000000", "000000", "000000", "000000", "000000", "130400"],
    ["130400", "000000", "000000", "000000", "000000", "000000", "130400", "000000", "000000", "000000", "000000", "000000", "000000", "000000", "000000", "000000", "000000", "000000", "000000", "000000", "000000", "000000", "000000", "000000", "000000", "000000", "000000", "000000", "000000", "000000", "000000", "000000", "000000", "000000", "000000", "000000", "000000", "000000", "000000", "000000", "000000", "000000", "000000", "000000", "000000", "000000", "000000", "000000", "000000", "000000", "000000", "000000", "000000", "000000", "000000", "000000", "000000", "000000", "000000", "000000", "000000", "000000", "000000", "000000", "000000", "000000", "000000", "000000", "000000", "000000", "000000", "000000", "000000", "000000", "000000", "000000", "130400"],
    ["130400", "130000", "000000", "000000", "000000", "000000", "130400", "000000", "000000", "000000", "000000", "000000", "000000", "000000", "000000", "000000", "000000", "000000", "000000", "000000", "000000", "000000", "000000", "000000", "000000", "000000", "000000", "000000", "000000", "000000", "000000", "000000", "000000", "000000", "000000", "000000", "000000", "000000", "000000", "000000", "000000", "000000", "000000", "000000", "000000", "000000", "000000", "000000", "000000", "000000", "000000", "000000", "000000", "000000", "000000", "000000", "000000", "000000", "000000", "000000", "000000", "000000", "000000", "000000", "000000", "000000", "000000", "000000", "000000", "000000", "000000", "000000", "000000", "000000", "000000", "000000", "130400"],
    ["130400", "000000", "000000", "000000", "130000", "130000", "130400", "000000", "000000", "000000", "000000", "000000", "000000", "000000", "000000", "000000", "000000", "000000", "000000", "000000", "000000", "000000", "000000", "000000", "000000", "000000", "000000", "000000", "000000", "000000", "000000", "000000", "000000", "000000", "000000", "000000", "000000", "000000", "000000", "000000", "000000", "000000", "000000", "000000", "000000", "000000", "000000", "000000", "000000", "000000", "000000", "000000", "000000", "000000", "000000", "000000", "000000", "000000", "000000", "000000", "000000", "000000", "000000", "000000", "000000", "000000", "000000", "000000", "000000", "000000", "000000", "000000", "000000", "000000", "000000", "000000", "130400"],
    ["130400", "000000", "000000", "000000", "000000", "000000", "000000", "130000", "000000", "000000", "000000", "000000", "000000", "000000", "000000", "000000", "000000", "000000", "000000", "000000", "000000", "000000", "000000", "000000", "000000", "000000", "000000", "000000", "000000", "000000", "000000", "000000", "000000", "000000", "000000", "000000", "000000", "000000", "000000", "000000", "000000", "000000", "000000", "000000", "000000", "000000", "000000", "000000", "000000", "000000", "000000", "000000", "000000", "000000", "000000", "000000", "000000", "000000", "000000", "000000", "000000", "000000", "000000", "000000", "000000", "000000", "000000", "000000", "000000", "000000", "000000", "000000", "000000", "000000", "000000", "000000", "130400"],
    ["130400", "000000", "130300", "130300", "130300", "000000", "000000", "000000", "000000", "000000", "000000", "000000", "000000", "000000", "000000", "000000", "000000", "000000", "000000", "000000", "000000", "000000", "000000", "000000", "000000", "000000", "000000", "000000", "000000", "000000", "000000", "000000", "000000", "000000", "000000", "000000", "000000", "000000", "000000", "000000", "000000", "000000", "000000", "000000", "000000", "000000", "000000", "000000", "000000", "000000", "000000", "000000", "000000", "000000", "000000", "000000", "000000", "000000", "000000", "000000", "000000", "000000", "000000", "000000", "000000", "000000", "000000", "000000", "000000", "000000", "000000", "000000", "000000", "000000", "000000", "000000", "130400"],
    ["130400", "130000", "130000", "130000", "130000", "130000", "130000", "130000", "130000", "130000", "130000", "130000", "000000", "130000", "130000", "130000", "130000", "130000", "130000", "130000", "130000", "130000", "130000", "130000", "130000", "130000", "130000", "130000", "130000", "130000", "130000", "130000", "130000", "130000", "130000", "130000", "130000", "130000", "130000", "130000", "130000", "130000", "130000", "130000", "130000", "130000", "130000", "130000", "130000", "130000", "130000", "130000", "130000", "130000", "130000", "130000", "130000", "130000", "130000", "130000", "130000", "130000", "130000", "130000", "130000", "130000", "130000", "130000", "130000", "130000", "130000", "130000", "130000", "130000", "130000", "130000", "130400"],
    ["130400", "000000", "000000", "000000", "000000", "000000", "000000", "000000", "000000", "000000", "000000", "000000", "000000", "000000", "000000", "000000", "000000", "000000", "000000", "000000", "000000", "000000", "000000", "000000", "000000", "000000", "000000", "000000", "000000", "000000", "000000", "000000", "000000", "000000", "000000", "000000", "000000", "000000", "000000", "000000", "000000", "000000", "000000", "000000", "000000", "000000", "000000", "000000", "000000", "000000", "000000", "000000", "000000", "000000", "000000", "000000", "000000", "000000", "000000", "000000", "000000", "000000", "000000", "000000", "000000", "000000", "000000", "000000", "000000", "000000", "000000", "000000", "000000", "000000", "000000", "000000", "130400"],
    ["130400", "000000", "000000", "000000", "000000", "000000", "000000", "000000", "000000", "000000", "000000", "000000", "000000", "000000", "000000", "000000", "000000", "000000", "000000", "000000", "000000", "000000", "000000", "000000", "000000", "000000", "000000", "000000", "000000", "000000", "000000", "000000", "000000", "000000", "000000", "000000", "000000", "000000", "000000", "000000", "000000", "000000", "000000", "000000", "000000", "000000", "000000", "000000", "000000", "000000", "000000", "000000", "000000", "000000", "000000", "000000", "000000", "000000", "000000", "000000", "000000", "000000", "000000", "000000", "000000", "000000", "000000", "000000", "000000", "000000", "000000", "000000", "000000", "000000", "000000", "000000", "130400"],
    ["130400", "000000", "000000", "000000", "000000", "000000", "000000", "000000", "000000", "000000", "000000", "000000", "000000", "000000", "000000", "000000", "000000", "000000", "000000", "000000", "000000", "000000", "000000", "000000", "000000", "000000", "000000", "000000", "000000", "000000", "000000", "000000", "000000", "000000", "000000", "000000", "000000", "000000", "000000", "000000", "000000", "000000", "000000", "000000", "000000", "000000", "000000", "000000", "000000", "000000", "000000", "000000", "000000", "000000", "000000", "000000", "000000", "000000", "000000", "000000", "000000", "000000", "000000", "000000", "000000", "000000", "000000", "000000", "000000", "000000", "000000", "000000", "000000", "000000", "000000", "000000", "130400"],
    ["130400", "000000", "000000", "000000", "000000", "000000", "000000", "000000", "000000", "000000", "000000", "000000", "000000", "000000", "000000", "000000", "000000", "000000", "000000", "000000", "000000", "000000", "000000", "000000", "000000", "000000", "000000", "000000", "000000", "000000", "000000", "000000", "000000", "000000", "000000", "000000", "000000", "000000", "000000", "000000", "000000", "000000", "000000", "000000", "000000", "000000", "000000", "000000", "000000", "000000", "000000", "000000", "000000", "000000", "000000", "000000", "000000", "000000", "000000", "000000", "000000", "000000", "000000", "000000", "000000", "000000", "000000", "000000", "000000", "000000", "000000", "000000", "000000", "000000", "000000", "000000", "130400"],
    ["130400", "000000", "000000", "000000", "000000", "000000", "000000", "000000", "000000", "130200", "130200", "130200", "000000", "000000", "000000", "000000", "000000", "000000", "000000", "000000", "000000", "000000", "000000", "000000", "000000", "000000", "000000", "000000", "000000", "000000", "000000", "000000", "000000", "000000", "000000", "000000", "000000", "000000", "000000", "000000", "000000", "000000", "000000", "000000", "000000", "000000", "000000", "000000", "000000", "000000", "000000", "000000", "000000", "000000", "000000", "000000", "000000", "000000", "000000", "000000", "000000", "000000", "000000", "000000", "000000", "000000", "000000", "000000", "000000", "000000", "000000", "000000", "000000", "000000", "000000", "000000", "130400"],
    ["130400", "000000", "000000", "000000", "000000", "000000", "000000", "000000", "000000", "000000", "000000", "000000", "000000", "000000", "000000", "000000", "000000", "000000", "000000", "000000", "000000", "000000", "000000", "000000", "000000", "000000", "000000", "000000", "000000", "000000", "000000", "000000", "000000", "000000", "000000", "000000", "000000", "000000", "000000", "000000", "000000", "000000", "000000", "000000", "000000", "000000", "000000", "000000", "000000", "000000", "000000", "000000", "000000", "000000", "000000", "000000", "000000", "000000", "000000", "000000", "000000", "000000", "000000", "000000", "000000", "000000", "000000", "000000", "000000", "000000", "000000", "000000", "000000", "000000", "000000", "000000", "130400"],
    ["130400", "000000", "000000", "000000", "000000", "000000", "000000", "000000", "000000", "000000", "000000", "000000", "000000", "000000", "000000", "000000", "000000", "000000", "000000", "000000", "000000", "000000", "000000", "000000", "000000", "000000", "000000", "000000", "000000", "000000", "000000", "000000", "000000", "000000", "000000", "000000", "000000", "000000", "000000", "000000", "000000", "000000", "000000", "000000", "000000", "000000", "000000", "000000", "000000", "000000", "000000", "000000", "000000", "000000", "000000", "000000", "000000", "000000", "000000", "000000", "000000", "000000", "000000", "000000", "000000", "000000", "000000", "000000", "000000", "000000", "000000", "000000", "000000", "000000", "000000", "000000", "130400"],
    ["130400", "000000", "000000", "000000", "000000", "000000", "000000", "000000", "000000", "000000", "000000", "000000", "000000", "000000", "000000", "000000", "000000", "000000", "000000", "000000", "000000", "000000", "000000", "000000", "000000", "000000", "000000", "000000", "000000", "000000", "000000", "000000", "000000", "000000", "000000", "000000", "000000", "000000", "000000", "000000", "000000", "000000", "000000", "000000", "000000", "000000", "000000", "000000", "000000", "000000", "000000", "000000", "000000", "000000", "000000", "000000", "000000", "000000", "000000", "000000", "000000", "000000", "000000", "000000", "000000", "000000", "000000", "000000", "000000", "000000", "000000", "000000", "000000", "000000", "000000", "000000", "130400"],
    ["130400", "000000", "000000", "000000", "000000", "000000", "000000", "000000", "000000", "000000", "000000", "000000", "000000", "000000", "000000", "000000", "000000", "000000", "000000", "000000", "000000", "000000", "000000", "000000", "000000", "000000", "000000", "000000", "000000", "000000", "000000", "000000", "000000", "000000", "000000", "000000", "000000", "000000", "000000", "000000", "000000", "000000", "000000", "000000", "000000", "000000", "000000", "000000", "000000", "000000", "000000", "000000", "000000", "000000", "000000", "000000", "000000", "000000", "000000", "000000", "000000", "000000", "000000", "000000", "000000", "000000", "000000", "000000", "000000", "000000", "000000", "000000", "000000", "000000", "000000", "000000", "130400"],
    ["130400", "000000", "000000", "000000", "000000", "000000", "000000", "000000", "000000", "000000", "000000", "000000", "000000", "000000", "000000", "000000", "000000", "000000", "000000", "000000", "000000", "000000", "000000", "000000", "000000", "000000", "000000", "000000", "000000", "000000", "000000", "000000", "000000", "000000", "000000", "000000", "000000", "000000", "000000", "000000", "000000", "000000", "000000", "000000", "000000", "000000", "000000", "000000", "000000", "000000", "000000", "000000", "000000", "000000", "000000", "000000", "000000", "000000", "000000", "000000", "000000", "000000", "000000", "000000", "000000", "000000", "000000", "000000", "000000", "000000", "000000", "000000", "000000", "000000", "000000", "000000", "130400"],
    ["130400", "000000", "000000", "000000", "000000", "000000", "000000", "000000", "000000", "000000", "000000", "000000", "000000", "000000", "000000", "000000", "000000", "000000", "000000", "000000", "000000", "000000", "000000", "000000", "000000", "000000", "000000", "000000", "000000", "000000", "000000", "000000", "000000", "000000", "000000", "000000", "000000", "000000", "000000", "000000", "000000", "000000", "000000", "000000", "000000", "000000", "000000", "000000", "000000", "000000", "000000", "000000", "000000", "000000", "000000", "000000", "000000", "000000", "000000", "000000", "000000", "000000", "000000", "000000", "000000", "000000", "000000", "000000", "000000", "000000", "000000", "000000", "000000", "000000", "000000", "000000", "130400"],
    ["130400", "000000", "000000", "000000", "000000", "000000", "000000", "000000", "000000", "000000", "000000", "000000", "000000", "000000", "000000", "000000", "000000", "000000", "000000", "000000", "000000", "000000", "000000", "000000", "000000", "000000", "000000", "000000", "000000", "000000", "000000", "000000", "000000", "000000", "000000", "000000", "000000", "000000", "000000", "000000", "000000", "000000", "000000", "000000", "000000", "000000", "000000", "000000", "000000", "000000", "000000", "000000", "000000", "000000", "000000", "000000", "000000", "000000", "000000", "000000", "000000", "000000", "000000", "000000", "000000", "000000", "000000", "000000", "000000", "000000", "000000", "000000", "000000", "000000", "000000", "000000", "130400"],
    ["130400", "000000", "000000", "000000", "000000", "000000", "000000", "000000", "000000", "000000", "000000", "000000", "000000", "000000", "000000", "000000", "000000", "000000", "000000", "000000", "000000", "000000", "000000", "000000", "000000", "000000", "000000", "000000", "000000", "000000", "000000", "000000", "000000", "000000", "000000", "000000", "000000", "000000", "000000", "000000", "000000", "000000", "000000", "000000", "000000", "000000", "000000", "000000", "000000", "000000", "000000", "000000", "000000", "000000", "000000", "000000", "000000", "000000", "000000", "000000", "000000", "000000", "000000", "000000", "000000", "000000", "000000", "000000", "000000", "000000", "000000", "000000", "000000", "000000", "000000", "000000", "130400"],
    ["130400", "000000", "000000", "000000", "000000", "000000", "000000", "000000", "000000", "000000", "000000", "000000", "000000", "000000", "000000", "000000", "000000", "000000", "000000", "000000", "000000", "000000", "000000", "000000", "000000", "000000", "000000", "000000", "000000", "000000", "000000", "000000", "000000", "000000", "000000", "000000", "000000", "000000", "000000", "000000", "000000", "000000", "000000", "000000", "000000", "000000", "000000", "000000", "000000", "000000", "000000", "000000", "000000", "000000", "000000", "000000", "000000", "000000", "000000", "000000", "000000", "000000", "000000", "000000", "000000", "000000", "000000", "000000", "000000", "000000", "000000", "000000", "000000", "000000", "000000", "000000", "130400"],
    ["130400", "000000", "000000", "000000", "000000", "000000", "000000", "000000", "000000", "000000", "000000", "000000", "000000", "000000", "000000", "000000", "000000", "000000", "000000", "000000", "000000", "000000", "000000", "000000", "000000", "000000", "000000", "000000", "000000", "000000", "000000", "000000", "000000", "000000", "000000", "000000", "000000", "000000", "000000", "000000", "000000", "000000", "000000", "000000", "000000", "000000", "000000", "000000", "000000", "000000", "000000", "000000", "000000", "000000", "000000", "000000", "000000", "000000", "000000", "000000", "000000", "000000", "000000", "000000", "000000", "000000", "000000", "000000", "000000", "000000", "000000", "000000", "000000", "000000", "000000", "000000", "130400"],
    ["130400", "000000", "000000", "000000", "000000", "000000", "000000", "000000", "000000", "000000", "000000", "000000", "000000", "000000", "000000", "000000", "000000", "000000", "000000", "000000", "000000", "000000", "000000", "000000", "000000", "000000", "000000", "000000", "000000", "000000", "000000", "000000", "000000", "000000", "000000", "000000", "000000", "000000", "000000", "000000", "000000", "000000", "000000", "000000", "000000", "000000", "000000", "000000", "000000", "000000", "000000", "000000", "000000", "000000", "000000", "000000", "000000", "000000", "000000", "000000", "000000", "000000", "000000", "000000", "000000", "000000", "000000", "000000", "000000", "000000", "000000", "000000", "000000", "000000", "000000", "000000", "130400"],
    ["130400", "000000", "000000", "000000", "000000", "000000", "000000", "000000", "000000", "000000", "000000", "000000", "000000", "000000", "000000", "000000", "000000", "000000", "000000", "000000", "000000", "000000", "000000", "000000", "000000", "000000", "000000", "000000", "000000", "000000", "000000", "000000", "000000", "000000", "000000", "000000", "000000", "000000", "000000", "000000", "000000", "000000", "000000", "000000", "000000", "000000", "000000", "000000", "000000", "000000", "000000", "000000", "000000", "000000", "000000", "000000", "000000", "000000", "000000", "000000", "000000", "000000", "000000", "000000", "000000", "000000", "000000", "000000", "000000", "000000", "000000", "000000", "000000", "000000", "000000", "000000", "130400"],
    ["130400", "000000", "000000", "000000", "000000", "000000", "000000", "000000", "000000", "000000", "000000", "000000", "000000", "000000", "000000", "000000", "000000", "000000", "000000", "000000", "000000", "000000", "000000", "000000", "000000", "000000", "000000", "000000", "000000", "000000", "000000", "000000", "000000", "000000", "000000", "000000", "000000", "000000", "000000", "000000", "000000", "000000", "000000", "000000", "000000", "000000", "000000", "000000", "000000", "000000", "000000", "000000", "000000", "000000", "000000", "000000", "000000", "000000", "000000", "000000", "000000", "000000", "000000", "000000", "000000", "000000", "000000", "000000", "000000", "000000", "000000", "000000", "000000", "000000", "000000", "000000", "130400"],
    ["130400", "130000", "130000", "130000", "130000", "130000", "130000", "130000", "130000", "130000", "130000", "130000", "130000", "130000", "130000", "130000", "130000", "130000", "130000", "130000", "130000", "130000", "130000", "130000", "130000", "130000", "130000", "130000", "130000", "130000", "130000", "130000", "130000", "130000", "130000", "130000", "130000", "130000", "130000", "130000", "130000", "130000", "130000", "130000", "130000", "130000", "130000", "130000", "130000", "130000", "130000", "130000", "130000", "130000", "130000", "130000", "130000", "130000", "130000", "130000", "130000", "130000", "130000", "130000", "130000", "130000", "130000", "130000", "130000", "130000", "130000", "130000", "130000", "130000", "130000", "130000", "130400"]
  ]
}
